1111111111111
1001P00000C01
100E011111001
1P0011E000001
1111111111111
