1111111111111
1001000000C01
1000011111001
1P0011E0C0001
1111111111111
