1111111111111
100E0C000P011
1111111111111
